Absence= The lack or unavailability of something or someone.
Approval= Having a positive opinion of something or someone.
Answer= The response or receipt to a phone call, question, or letter.
Attention= Noticing or recognizing something of interest.
Borrow= To take something with the intention of returning it after a period of time.
Generic= a group or class that does not have a brand name.
Banter= Conversation that is teasing and playful. 
Characteristic= referring to features that are typical to the person, place, or thing.
Care= extra responsibility and attention.
Dialogue= A conversation between two or more people. 
Decisive= a person who can make decisions promptly.
Effervescent= an event marked by excitement and high spirits. 
Eloquent= an individual who expresses themselves effectively and clearly.
Huddle= to gather together in a close mass or group.
Feasible= an activity that is possible. 
Jug= a utensil or container used to hold liquids.
Feeble= a person or statement that is unconvincing and weak. 
Idealistic= a person who is motivated by moral and noble beliefs as opposed to practicality.
Global= pertaining to the whole world; worldwide; universal:
Language= a body of words and the systems for their use common to a people who are of the same community or nation, the same geographical area, or the same cultural tradition
Machine= an apparatus consisting of interrelated parts with separate functions, used in the performance of some kind of work
Newspaper= a printed publication issued at regular and usually close intervals, especially daily or weekly, and commonly containing news, comment, features, and advertising
Opponent= a person who is on an opposing side in a game, contest, controversy, or the like; adversary.
Phone= a portable electronic telephone device, as a cell phone, mobile phone, or smartphone.
Salary= a fixed compensation periodically paid to a person for regular work or services.
Task= a definite piece of work assigned to, falling to, or expected of a person; duty.
Unique= existing as the only one or as the sole example; single; solitary in type or characteristics
Variable= apt or liable to vary or change; changeable
Whisper= to speak with soft, hushed sounds, using the breath, lips, etc., but with no vibration of the vocal cords.
Zone= any continuous area that differs in some respect, or is distinguished for some purpose, from adjoining areas, or within which certain distinctive circumstances exist or are established